96 60
BBBBBBBBBBBBBBBBBBBBBBBBBBBBBBBBBBBBBBBBBBBBBBBBBBBBBBBBBBBBBBBBBBBBBBBBBBBBBBBBBBBBBBBBBBBBBBB
B                   B   P  P  P  P  P   B    P   B                                            B
B                   B                   B        B      M         M                 W         B
B                   B                   B        B                                            B
B        C  C  C    B              C    B    C   B            P              P      C         B
B                   B                   B        B                                            B
B                   B                   B        B      P                                     B
BBBBBBBBBBBB   C    B              C    B    C   B                                  C         B
B          B        BBBBBBBBBBBBB  M  BBB        B            M   P                           B
B                                                                                             B
B                                                                                             B
B              C  C  C  C  C  C  C  C  C  C  C  C  C  C  P  C  C  C  C  C  C  C  C  P  C  C   B
B                                                                                             B
B          M                  F                        F           F           F              B
B                                                                                             B
B              C    BBBBBBBBBBBBBBBBBBBBBBBBBBBBBBBBBBBBBBBBBBBBBBBBBBBBBBBBBBBBBBBBB     C   B
B          B        B                                                                         B
B          B        B                                                                         B
B          B        B                                                                         B
B          B   C    B      P  C  C  C  C  C  C  C  C  C  C  C  P  C              C  C  C  C   B
B          B        B                                                                         B
B          B        B      C                                                                  B
B    K     B   P    B                                                                         B
BBBBBBBBBBBBBBBBBBBBB            BBBBBBBBBBBBBBBBBBBBBBBBBBBBBBBB M BBBBBBBBBBBBB M BBBBBBBBBBB
B                          C     B                              B C              C  B         B
B              C  C MC  C        B                  P           B                   B P  P  P B
B                                B    M                    M    B                   B         B
B                   B      C     B                              B C              C  B     C   B
B              C    B            B              M               B                   B         B
B                   B                                     P     B               F   B    M    B
B  F                B     PC  C  M  C  C  P  C  C  C  C  C      B     P  P  P       B     C   B
B              K    B                                           BBBBBBBBBBBBBBBBBBBBB         B
B                   B                                                                         B
BBBBBBBBBBBBBBBBBBBBB            B               P       S                                    B
B                          C     B                       C  C  C  C  C  C  C  C  C  C  C  C   B
B P  P  P  CF C  C  C  C         B     F        F        F                                    B
B                                B                                                            B
BBBBBBBBBBBBBBBBBBBBBBBBBBBBBBBBBBBBBBBBBBBBBBBBBBBBBBBBBBBBBBBBBBBBBBBBBBBBBBBBBBBBBBB   C   B
B       PPPPP             B                                                                   B
BN                        B                                                                   B
B                         B               M                         M                     C   B
B                         D                                                                   B
B               P                                                                             B
B                                                     C  C  C  C  C  C  C  C  C  C  C  C  C   B
B          V              B                                                                   B
B                         B                 M                                                 B
B                         B                                       C                           B
B                 P       B                                                                   B
B                         B      P                                      BBBBBBBBBBBBBBBBBBBBBBB
B                         B                                       C     B                     B
B                         B                            M                B                 P   B
BN                        B                                                                   B
B      P                  B                     P                 C  C  C  C  C               B
B                   P     B       M                                     M                 P   B
B                   P     B                                                                   B
B                         B                                                                   B
B                         B                                             B     C           P   B
B           V             B    F          F            F                B  F            F     B
BPPPPP                    B                                             B      K              B
BBBBBBBBBBBBBBBBBBBBBBBBBBBBBBBBBBBBBBBBBBBBBBBBBBBBBBBBBBBBBBBBBBBBBBBBBBBBBBBBBBBBBBBBBBBBBBB
